1101
3300000000222
3310000000222
3301000000222
3300100000222
3300010000222
3300001000222
3300000100222
3300000010222
3310000001222
3301020000222
3300122013222
3300122013222
