1010
 00001000000
 00000100000
 00000010000
 00000001000
 00000000100
 00000000010
 00000000001
 10000000005
 01000000000
 00105000000
