1113
33000000002220
33100000002220
33010000002220
33001000002220
33000100002220
33000010002220
33000001002220
33000000102220
33100000012220
33010200002220
33001220132220
33001220132220
33000000002220
33100000002220
33010000002220
33001000002220
33000100002220
33000010002220
33000001002220
33000000102220
33100000012220
33010200002220
33001220132220
33001220132220
