1010
3000000002
3100000002
3010000002
3001000002
3000100002
3000010002
3000001002
3000000102
3100000012
3010200002
